Theme,Total,UEQ,UEEQ,RAW,Release_Yes,Release_No
Usability,268,92,81,95,170,98
User Experience,157,58,70,29,61,96
Functionality,154,54,59,41,97,57
Design Quality,130,31,68,31,60,70
Business Value,96,23,24,49,73,23
Trust,63,16,37,10,15,48
Ethics Manipulation,60,5,43,12,5,55
User Autonomy,55,1,34,20,22,33
Cognitive Load,54,10,17,27,40,14
Engagement,51,20,21,10,20,31
